2,4,5
1 1 1 1 1,1 0 0 0 1,1 0 0 0 1,0 0 0 0 0
1 1 0 1 1,0 0 0 0 0,0 0 0 0 0,1 0 0 0 1
5 20 20 -1,-1 0 0 20
3 -1 -1 -1 3,20 1 -1 1 20
-1 -1 1 -1 -1,-1 -1 -1 -1 -1,-1 -1 -1 -1 -1,1 0 0 0 1
# Glasses