9,2,5
0 1 1 1 0,0 1 1 1 0
1 0 0 0 1,1 1 1 1 1
1 0 0 0 1,1 1 1 1 1
1 0 0 0 1,1 1 1 1 1
0 1 1 1 0,0 1 1 1 0
0 0 0 0 0,0 0 1 0 0
0 0 0 0 0,0 0 1 0 0
0 0 0 0 0,0 0 1 0 0
0 0 0 0 0,0 0 1 0 0
3 3,20 -1,20 5,20 -1,3 3,0 1,0 1,0 1,0 1
-1 -1 -1 -1 -1,-1 -1 1 1 -1,-1 -1 -1 -1 -1,-1 -1 1 1 -1,-1 -1 -1 -1 -1,-1 -1 1 -1 -1,-1 -1 -1 -1 -1,-1 -1 -1 -1 -1,-1 -1 -1 -1 -1
3 20 20 -1 3,3 5 -1 5 3
# Magnifying glass