3,7,5
1 1 1 1 1,1 1 1 1 1,0 0 1 0 0,0 0 1 0 0,0 0 1 0 0,0 0 1 0 0,0 0 1 0 0
1 0 1 0 1,0 0 0 0 0,0 0 0 0 0,0 0 0 0 0,0 0 1 0 0,0 0 1 0 0,0 0 1 0 0
1 0 1 0 1,0 0 0 0 0,0 0 0 0 0,0 0 0 0 0,0 0 0 0 0,0 0 0 0 0,0 0 0 0 0
5 -1 1 1 1 1 1,300 -1 -1 -1 1 -1 -1,300 0 -1 -1 0 -1 -1
2 2 -1 2 2,1 0 40 0 1,1 0 -1 0 1
-1 -1 -1 -1 -1,-1 -1 1 -1 -1,-1 -1 1 -1 -1,-1 -1 1 -1 -1,0 -1 -1 -1 0,-1 -1 2 -1 -1,-1 -1 2 -1 -1
# Spiked rake