6,2,7
0 0 0 0 0 0 0,0 0 0 1 0 0 0
0 0 0 0 0 0 0,0 1 1 1 1 1 0
0 1 0 0 0 1 0,1 1 1 1 1 1 1
1 1 1 0 1 0 1,1 1 1 1 1 1 1
0 1 0 0 0 1 0,1 1 1 1 1 1 1
0 0 0 0 0 0 0,0 1 1 0 1 1 0
0 1,-1 5,-1 7,500 7,-1 7,0 40
-1 -1 -1 1 -1 -1 -1,-1 -1 -1 -1 -1 -1 0,-1 -1 -1 -1 -1 2 1,-1 -1 -1 -1 -1 -1 -1,-1 2 -1 -1 -1 -1 1,-1 -1 -1 -1 -1 -1 -1
1 3 1 0 1 20 -1,3 5 5 5 5 5 3
# Gameboy