5,3,5
0 0 0 0 0,0 1 0 1 0,0 0 0 0 0
0 1 1 1 0,1 1 1 1 1,0 1 1 1 0
0 1 1 1 0,1 1 1 1 1,0 1 1 1 0
0 0 1 0 0,0 1 1 1 0,0 0 1 0 0
0 0 0 0 0,0 0 1 0 0,0 0 0 0 0
-1 2 -1,3 5 3,3 5 3,1 3 1,0 1 0
0 1 0 1 0,1 3 3 3 1,1 3 300 3 1,0 1 3 1 0,0 0 1 0 0
0 2 3 2 0,2 4 4 4 2,0 20 3 2 0